汪礼衽	现代分析基础
李良攀	现代分析基础、数学分析
殷浩	现代分析基础、数学分析
戎锋	现代分析基础
乃兵	数学分析
金石	数学分析
武同锁	代数、线性代数、抽象代数
冯卫国	概率论与数理统计
陈新兴	概率论及其应用
吴耀琨	概率论及其应用、图论
韩东	概率论
仇璘	科学与工程计算
谢建利	科学与工程计算
王增琦	科学工程与计算
马红孺	大学物理
卢文发	大学物理
胡其图	大学物理
李晟	物理学引论
周玲玲	模拟电路、电路与电子学
陈平	数字逻辑
翁惠玉	计算机科学导论、程序设计、数据结构、计算机网络
梁阿磊	计算机科学导论及讨论课、计算机组成与系统结构
程国英	程序设计
窦延平	数据结构
沈恩绍	基础集论、集合论与数理逻辑、数理逻辑、计算理论、应用逻辑
陈翌佳	算法分析与设计、图论与组合 
朱洪	算法设计基础
陈晓敏	图论与组合
傅育熙	可计算性理论、并行理论、程序语言理论、计算理论
过敏意	编译原理
沈耀	编译原理
张冬茉	编译原理
尤晋元	操作系统
邹恒明	操作系统、数据库系统原理
朱其立	数据库系统原理
陆朝俊	数据库系统原理
马范援	计算机网络
朱燕民	计算机网络
张丽清	人工智能、统计学习与推理
吕宝粮	人工智能、神经网络理论与应用
饶若楠	面向对象方法与技术
曹珍富	密码学基础
林德璋	软件工程
俞勇	基础实践、科研实践、学子讲坛、科研专题
张尧弼	微机与接口技术
骆源	信息论与编码
邓玉欣	程序语言理论
伍民友	高级计算机系统结构
王英林	机器学习
姚天昉	基于Internet的信息获取技术、自然语言理解
来学嘉	密码工程
苑波	生物信息学
卢宏涛	数字图象处理
马利庄	计算机图形学
